וחקל רוח קרויהון לא יזדבן ארי אחסנת עלם הוא להון :
וכי ימוך אחיך ומטה ידו עמך והחזקת
בו גר ותושב וחי עמך : וארי יתמסכן אחוך ותמוט ידיה עמך
ותתקיף ביה דיר ותיתב ויחי עמך : אל תקח מאתו נשך ותרבית
ויראת מאלהיך וחי אחיך עמך : לא תסב מיניה חבוליא ורביתא
ותדחל מאלהך ויחי אחוך עמך : את כספך לא תתן לו בנשך
ובמרבית לא תתן אכלך : ית כספך לא תתן ליה בחבוליא
וברביתא לא תתן מיכלך : אני יהוה אלהיכם אשר הוצאתי
אתכם מארץ מצרים לתת לכם את ארץ כנען להיות לכם לאלהים :
אנא ייי אלהכון דאפיקית יתכון מארעא דמצרים למתן לכון ית ארעא
דכנען למיהוי לכון לﭏה : וכי ימוך
אחיך עמך ונמכר לך לא תעבד בו עבדת עבד : וארי יתמסכן
אחוך עמך ויזדבן לך לא תפלח ביה פולחן עבדין : כשכיר כתושב
יהיה עמך עד שנת היבל יעבד עמך : כאגירא כתותבא יהי עמך
עד שתא דיובלא יפלח עמך : ויצא מעמך הוא ובניו עמו ושב
אל משפחתו ואל אחזת אבתיו ישוב : ויפוק מעמך הוא ובנוהי
עמיה ויתוב לזרעיתיה ולאחסנת אבהתוהי יתוב : כי עבדי
הם אשר הוצאתי אתם מארץ מצרים לא ימכרו ממכרת עבד :
ארי עבדי אינון דאפיקית יתהון מארעא דמצרים לא יזדבנון
זבון עבדין : לא תרדה בו בפרך ויראת מאלהיך : לא תפלח
ביה בקשיו ותדחל מﭏהך : ועבדך ואמתך אשר יהיו לך
מאת הגוים אשר סביבתיכם מהם תקנו עבד ואמה : ועבדך
ואמתך דיהון לך מן עממיא די בסחרניכון מנהון תקנון [ע']
עבדין ואמהן : וגם מבני התושבים הגרים עמכם מהם תקנו [וצצש']
וממשפחתם אשר עמכם אשר הולידו בארצכם והיו לכם
לאחזה : ואף מבני תותביא עריליא דדירין עימכון מנהון
תקנון ומזרעיתהון די עמכון דאתילידו בארעכון ויהון לכון
לאחטנא : והתנחלתם  אתם לבניכם אחריכם לרשת אחזה לעלם
בהם תעבדו ובאחיכם בני ישראל איש באחיו לא תרדה בו
בפרך : ותחסנון יתהון לבניכון בתריכון לירותת אחסבא לעלם
בהון תפלחרך ובאחומבהון תנלחון בני ישר' גבר כאחותי לא תפלח כיה
בקשיו : וכי תשיג יד גר ותושב עמך ומך אחיך עמו ונמכר לגר
תושב עמך או לעקר משפחת גר : וארי תדביק יד ערל ותותב
עימך ויתמסכן אחוך עמיה ויזדבן לערל תותב עמך או לארמי
זרעית גיורא : אחרי נמכר גאלה תהיה לו אחד מאחיו יגאלנו
בהר דיזדבן כורקנא תהי ליה חד מאחוהי יפרקיניה : או דרו או בן
דדו יגאלנו או משאר בשרו ממשפחתו יגאלנו או השיגה ידו
ונגאל : או אח אבוהי או בר אח אבוהי יפרקיניה או מקריב
בשריה מזרעיתיה יפרקיניה או דתדבק ידיה ויתפריק :
וחשב עם קנהו משנת המכרו לו עד שנת היבל והיה כסף
ממכרו במספר שנים כימי שכיר יהיה עמו : ויחשב עם זבנוהי
משתא דאזדבן ליה עד שתא דיובלא ויהי כסף זבינוהי
גמנין שבנא ביומי אתדא יהא עשויה : אם עוד רבות בשנים
לפיהן ישיב גאלתו מכסף מקנתו : אם עוד סגיאות בשניא כס
לפומהן יתב פורקניה מכסף זבינוהי : ואם מעט נשאר
בשנים עד שנת היבל וחשב לו כפי שניו ישיב את גאלתה : ואה
זעיר אשתאר בשניא עד שתא דיובלא ויחשב ליה כפום
שנוהי יתיב ית פורקניה : כשכיר שנה בשנה יהיה עמו לא
ירדנו בפרך לעיניך : כאגיר שנא בשנא יהא עמיה לא יפלח
ביה בקשיו לעינך : ואם לא יגאל באלה ויצא בשנת היבל
הוא ובניו עמו : ואם לא יתפרק באלין ויפוק בשתא דיובילא
הוא ובנוהי עמיה : כי לי בני ישראל עבדים עבדי הם אשר