ושרש צדיקים בל ימוט : אשת
חיל עטרת בעלה וכרקב בעצמותיו
מבישה : מחשבות צדיקים משפט
תחבלות רשעים מרמה : דברי רשעים
ארב דם ופי ישרים יצילם : הפוך [ר']
רשעים ואינם ובית צדיקים יעמד :
לפי שכלו יהלל איש ונעוה לב יהיה
לבוז : טוב נקלה ועבד לו ממתכבד
וחסר לחם : יודע צדיק נפש בהמתו
ורחמי רשעים אכזרי : עבד אדמתו
ישבע לחם ומרדף רקים חסר לב :
חמד רשע מצוד רעים ושרש [צ']
צדיקים יתן : בפשע שפתים מוקש
רע ויצא מצרה צדיק : מפרי פי [א']
איש ישבע טוב וגמול ידי אדם
ישיב לו : דרך אויל ישר בעיניו [ו']
ושמע לעצה חכם : אויל ביום יודע
כעסו וכסה קלון ערום : יפיח אמונה
יגיד צדק ועד שקרים מרמה : יש
בטה כמדקרות חרב ולשון חכמים
מרפא : שפת אמת תכון לעד ועד
ארגיעה לשון שקר : מרמה בלב
חרשי רע וליעצי שלום שמחה :
לא יאנה לצדיק כל און ורשעים
מלאו רע : תועבת יהוה שפתי שקר
ועשי אמונה רצונו : אדם ערום
בסה דעת ולב כסילים יקרא אולת :
יד חרוצים תמשל ורמיה תהיה למס :
דאגה בלב איש ישחנה ודבר טוב
ישמחנה : יתר מרעהו צדיק ודרך
רשעים תתעם : לא יחרך רמיה צידו
והון אדם יקר חרוץ : בארח צדקה
חיים ודרך נתיבה אל מות : בן חכם
מוסר אב ולץ לא שמע גערה : מפרי
פי איש יאכל טוב ונפש בגדים חמס :
נצר פיו שמר נפשו פשק שפתיו מחתה
לו : מתאוה ואין נפשו עצל ונפש
חרצים תדשן : דבר שקר ישנא צדיק
ורשע יבאיש ויחפיר : צדקה תצור
תם דרך ורשעה תסלף חטאת : יש
מתעשר ואין כל מתרושש והון רב :
כפר נפש איש עשרו ורש לא ישמע
גערה : אור צדיקים ישמח ונר רשעים
ידעך : רק בזדון יתן מצה ואת נועצים
חכמה : הון מהבל ימעט וקבץ על יד
ירבה : תוחלת ממושכה מחלה לב ועץ
חיים תאוה באה : בז לדבר יחבל לו
וירא מצוה הוא ישלם : תורת חכם
מקור חיים לסור ממקשי מות : שכל טוב
יתן חן ודרך בגדים איתן : כל ערום
יעשה בדעת וכסיל יפרש אולת : מלאך
רשע יפל ברע וציר אמונים מרפא :