ירחמאל בני חצרון הבכור רם ובונה ואורן יאצם אהיה : ותי
אשה אחרת לירחמאל ושמה עטרה היא אם אונם : ויהי בני
רם בכור ירחמאל מעץ וימין ועקר : ויהיו בני אונם שמי וידע
ובני שמי נדב ואבישור : ושם אשת אבישור אביהיל ותלד
לו את אחבן ואת מוליד : ובני נדב סלד ואפים וימת סלד לא
בנים : ובני אפים ישעי ובני ישעי ששן אחלי : ובני ידע אחי
שמי יתר ויונתן וימת יתר לא בנים : ובני
יונתן פלת וזזא אלה היו בני ירחמאל : ולא היה לששן בנים
כי אם בנות ולששן עבד מצרי ושמו ירחע : ויתן ששן את בתו
לירחע עבדו לאשה ותלד לו את עתי : ועתי הוליד את נתן [//]
ונתן [/] הוליד את זבד : וזבד הוליד את אפלל ואפלל הוליד את
עובד : ועובד הוליד את יהוא ויהוא הוליד את עזריה : [ועז']
ועזריה הוליד את חלץ וחלץ הוליד את אלעשה : ואלעשה
הוליד את ססמי וססמי הוליד את שלום : ושלום הוליד את
יקמיה ויקמיה הוליד את אלישמע :
ובני כלב אחי ירחמאל מישע בכורו הוא אבי זיף ובני מרשה
אבי חברון : ובני חברון קרח ותפח ורקם ושמע : ושמע הוליד
את רחם אבי ירקעם : ורקם הוליד את שמי : ובן שמי מעון
ומעון אבי בית צור : ועיפה פילגש כלב ילדה את חרן
ואת מוצא ואת גזז וחרן הוליד את גזז
ובני יהדי רגם ויותם וגישן ופלט ועיפה ושעף : פלגש
כלב מעכה ילד שבר ואת תרחנה : ותלד שעף אבי : מדמנה
גד ואשר : בני יהודה ער ואונן ושלה שלשה נולד לו מבת [/]
שוע הכנענית : ויהי ער בכור יהודה רע בעיני יהוה וימיתהו :
והוה : ותמר כלתו ילדה לו את פרץ ואת זרח כל [אלה] בני יהודה
חמשה : בני פרץ חצרון וחמול : ובני זרח זמרי ואיתן והימן
וכלכל ודרע כולם חמשה : ובני כרמי עבר [עובד] עובר ישראל
אשר מעל בחרם ובני איתן עזריה : : ובני חצרון אשר
נולד לו את ירחמאל ואת רם ואת כלובי : ורם הוליד את עמינדב
ועמינדב הוליד את נחשון נשיא בני יהודה : ונחשון הוליד את
שלמא ושלמא הוליד את בעז : ובעז הוליד את עובד ועבד
הוליד את ישי : וישי הוליד את בכרו את אליאב ואבינדב השני
ושמעא השלישי : נתנאל הרביעי רדי החמישי : אצם הששי
דוד השביעי : ואחיותיהם צרויה ואביגיל ובני צרויה אבשי [//]
ויואב ועשאל שלשה : ואביגיל ילדה את עמשא ואבי עמשא
יתר הישמעאלי : וכלב בן חצרון הוליד את עזובה אשה ואת
יריעות ואלה בניה ישר ושובב וארדון : ותמת עזובה ויקח
לו כלב את אפרת ותלד לו את חור : וחור הוליד את אורי ואורי
הוליד את בצלאל : ואחר בא חצרון אל בית מכיר אבי גלעד
והוא לקחה והוא בן ששים שנה ותלד לו את שגוב : ושגוב הוליד
את יאיר ויהי לו עשרים ושלש ערים בארץ הגלעד : ויקח גשור
וארם את חות יאיר מאתם את קנת ואת בנתיה ששים עיר
כל אלה בני מכיר אבי גלעד : ואחר מות חצרון בכלב אפרתה
ואשת חצרון אביה ותלד לו את אשחור אבי תקוע : ויהיו בני