וכלוב אחי שוחה הוליד את מחיר הוא אבי אשתון : ואשתון הוליד
את בית רפא ואת פסח ואת תחנה אבי עיר נחש אלה אננדו [/]
בני רכה : ובני קנז עתניאל ושריה ובני עתניאל
חתת : ומעותי הוליד את עפרה ושריה הוליד את יואב אבי
גיא חדשים כי חרשים היו : ובני כלב בן יפונה עירו : אלה
ונעם ובני אלה וקנז : ובני יהללאל זיף וזיפא תריא ואשראל :
ובן עזרה יתר ומרד ועפר וילון ותהר את מרים ואת שמי
ואת ישבח אבי אשתמע : ואשתו היהודייה ילדה את ירד
אבי גדור ואת חבר אבי שוכו ואת יקותיאל אבי זנוח ואלה
בני בתיה בת פרעה אשר לקח מרד :
ובני אשת הודייה אחות נחם אבי קעילה הגרמי ואשתמע
המעכתי : ובני שימון אמנון ורנה בן חנן ותולון ובני ישעי
זוחת ובן זוחת : בני שלה בן יהודה ער אבי לכה ולעדה
אבי מרשה ומשפחת בית עבדת הבץ לבית אשבע : ויוקים
ואנשי כזבא ויואש ושרף אשר בעלו למואב ויושבי לחם :
והדברים עתיקים : המה היצרים ויושבי נטעים וגדרה
עם המלך במלאכתו שם : בני שמעון נמואל
וימין יריב זרח שאול : שלום בנו מבשם בנו משמע בנו :
ובני משמע חמואל בנו זכור בנו שמעי בנו : ולשמעי בנים
ששה עשר ובנות שש ולאחיו אין בנים רבים וכל [משפ']
משפחתם לא הרבו עד בני יהודה : וישבו בבאר שבע
ומולדה וחצר שועל : ובבלהה ובעצם ובתולד : ובבתואל
ובחרמה ובציקלג : ובבית מרכבות בחצר סוסים ובבית
בראי ובשערים אלה עריהם עד מלך דוד : וחצריהם עיטם
ועין רמון ותכן ועשן ערים חמש : וכל חצריהם אשר סביבות
הערים האלה עד בעל זאת מושבותם והתיחשם להם :
ומשובב וימלוך ויושה בן אמציה : ויואל ויהוא בן יושביה
בן שריה בן עשיאל : ואליועצי ויעקביה וישוחיה ועשיה
ועדיאל וישימיאל ובניה : וזיזא בן שפעי בן אלון בן ידיה :
בן שמרי בן שמעיה : אלה הבאים בשמות נשיאים [במשפ']
במשפחתם ובית אבותיהם פרצו לרב : וילכו למבוא גדר
עד למזרח הגיא לבקש מרעה לצאנם : וימצאו מרעה שמן
וטוב והחרץ רחבת ידים ושקטת ושלוה  כי מן חם [הי//]
הישבים שם לפנים : ויבאו אלה הכתובים בשמות בימי
יחזקיהו מלך יהודה ויכו את אהליהם ואת המעינים אשר
נמצאו שמה ויחרמם עד היום הזה וישבו תחתיהם כי
מרעה לצאנם שם : ומהם מן בני שמעון הלכו להר שעיר
אנשים חמש מאות ופלטיה ונעריה ורפיה ועזיאל בני ישעי
בראשם : ויכו את שארית הפליטה לעמלק וישבו שם עד
היום הזה : ובני ראובן בכור ישראל כי הוא הבכר
ובחללו יצועי אביו נתנה בכורתו לבני יוסף בן ישראל ולא
להתיתש כי יהודה גדר באתיו ולנגיד ממנו והבבורה ליוסף :
בני ראובן בכור ישראל חנוך ופלוא חצרון וכרמי :
בני יואל שמעיה בנו גוג : בנו שמעי בנו : מיכה בנו ראיה