את שוא אבי מכבנה ואבי גבעא ובת כלב עכסא : אלה היו
בני כלב בן חור בכור אפרתה שובל אבי קרית יערים : שלמא
אבי בית לחם חרף אבי בית גדר : ויהיו בנים לשובל אבי קרית
יערים הראה חצי המנחות : ומשפחות קרית יערים היתרי
והפותי והשמתי והמשרעי מאלה יצאו הצרעתי והאשתאלי :
בני שלמא אבי בית לחם ונטופתי
עטרות בית יואב וחצי המנחתי הצרעי : ומשפחות סופרים
ישבו יעבץ תרעתים שמעתים שוכתים המה הקנים הבאים
מחמת אבי רכב : ואלה היו בני דוד אשר נולד
לו בחברון הבכור אמנון לאחינו עם היזרעאלית שני דניאל
לאביגיל הכרמלית : השלישי לאבשלום בן מעכה בת תלמי
מלך גשור הרביעי אדניה בן חגית : החמישי שפטיה לאביטל
הששי יתרעם לעגלה אשתו : ששה לו בחברון וימלוך שם
שבע שנים וששה חדשים ושלשים ושלש שנה מלך בירושלם :
ואלה נולדו לו בירושלם שמעא ושובב ונתן ושלמה :
ארבעה לבת שוע בת עמיאל : ויבחר ואלישמע ואליפלט :
ונגה ונפג ויפיע : ואלישמע ואלידע ואליפלט תשעה :
כל בני דוד מלבד בני פילגשים ותמר אחתם :
ובן שלמה רחבעם אביה בנו אסא בנו יהושפט בנו ˙ יורם
בנו אחזיהו בנו יואש בנו : אמציהו בנו עזריה בנו יותם
בנו : אחז בנו חזקיהו בנו מנשה בנו : אמון בנו יאשיהו
בנ י: ובנו יאשיהו הבסור יומנו השע יהויקים השלישי
צדקיהו הרביעי שלום : ובני יהויקים יכניה בנו צדקיה בנו :
ובני יכניה אסר שאלתיאל בנו : ומלכי רם ופדיה ושנאצר
יקמיה הושמע ונדביה : ובני פדיה זרבבל ושמעי ובן : זרובבל
משלם וחנניה ושלמית אחתם : וחשבה ואהל וברכיה וחסדיה
יושב חסד חמש : ובן חנניה פלטיה וישעיה בני רפיה בני
ארנן בני עבדיה בני שכניה :
ובני שכניה שמעיה ובני שמעיה חטוש ויגאל
ובריח ונעריה ושפט ששה : ובן נעריה אליועני וחזקיה ועזריקם
שלשה : ובני אליועיני הודויהו ואלישיב ופליה ועקוב ויוחנן
ודליה וענני שבעה : בני יהודה פרץ [חצ']
חצרון וכרמי וחור ושובל : וראיה בן שובל הוליד את יחת ויחת
הוליד את אחומי ואת להד אלה משפחות הצרעתי :
ואלה אבי עיטם יזרעאל וישמא וידבש ושם אחתם הצללפוני :
ופנואל אבי גדור [//] ועזר אבי חושה אלה בני חול בכור [אפ']
אפרתה אבי בית לחם : ולאחשור אבי תקוע היו שתי נשים
חלאה ונערה : ותלד לו נערה את אחזם ואת חפר ואת תימני :
ואת האחשתרי אלה בני נערה : ובני חלאה צרת יצחר ואתנן :
וקוץ הוליד את ענוב ואת הצבבה ומשפחות אחר אל בן
חרום : ויהי יעבץ נכבד מאחיו ואמו קראה שמו יעבץ לאמר
כי ילדתי בעצב : ויקרא יעבץ לאלהי ישראל לאמר אם
ברך תברכני והרבית את גבולי והיתה ידך עמי ועשית מרעה
לבלתי עצבי ויבא אלהים את אשר שאל :